[[,,[[[.......................
[[[[.,....................,,..
...........,,,............,,..
...........,,,................
...........,,,................
......~~~~............,,,,.....
......................,,,,....
.............[[[[.............
..............[[[.............
.....,,,,.[[[[[[[....,,,,.....
.....,,,,...........,,,,,,....
......,,,............,,,,.....
......................,,......
........~~~~..................
...........~.............,,,,,