ttttt.........................
..ttttt...........r...........
,,,,tttt````.......,,,,,,,,,,,
ttt....,,,....,,,,....,,..~~~~
.......,,,...,,,,,........~~~~
.......tt..,,,.....r...~~~~~~~
......~~~~............,,,,....
.....,,,,.............,,,,....
.......,,....[[[[..........ttt
...ttt........[[[.........tt.t
.....,,,,.[[[[[[[....r,,,,.....
.....,,,,...........,,,,,,....
,,,,,,,,,......rr....,,,,.....
,,,,,,,,,,............,,......
,,,,,,,,~~~~................,,
,,,,,......~.............,,,,,