[[,,[[[.......................
[[[[.,.............r......,,..
...........,,,............,,..
...........,,,................
...........,,,.....r..........
......~~~~............,,,,.....
......................,,,,....
.............[[[[.............
..............[[[.............
.....,,,,.[[[[[[[....,,,,.....
.....,,,,...........,,,,,,....
......,,,......rr....,,,,.....
......................,,......
........~~~~..................
...........~.............,,,,,