ttttttttt...~~~~~~~...........
tttttttt......,,~~~~~~~~~~~~~~
tttttt..........,,~,,,,,,,,,,,
.......,,,.....,,,~...,,,,,,,,
.,,,,,,,,,.......,,~,,,,,,,,,,
....,,,,,,......,,,,~~~~~~~~~~
,,,,,,,.,,,,,,,,,,,,,,,,......
,,,,,,,,,,,,,,,,,,,,,,,.......
...,..,,,,,,,,,,,........ttttt
,,,..........,,,,,,,,....,,,,,
,,,,,,,,,...~~~~~.............
,,,r,,,,,,,.........,,,,,.....
,,,,,,,,r,,,,..........,,,,...
............,,,,,,.ttr,tt.,,,.
......,,,,,,,,,,,,.....ttttttt
....~~,,.........,,,,,,,..tttt


